000000000000000000000000000000
000000000111111111111100000000
000000001000000000000011111100
001100001000000000000000000010
010010001000000000000000000010
010011111000000010000011000010
010000000000000010000011000011
100000000000000101000011000000
100000000000000010000011000000
100000000000000010000011000000
100000000000011101110011001111
010000000000010000010011001000
010000000110010000010000001000
010000000000010000010000001000
001111100000010000001111110000
000000100000010000000000000000
000000100001010000000000000000
000000100111010000000000000000
000000011000100000000000000000
000000000000000000000000000000