000000000000100010000000000000
000000000001000010000000000000
000000011111000001111110000000
011111100000000000000001111110
100000000000000000000000000001
100000000000000000000000000001
100000000000000000000000000001
010001110000000010000000000001
010001011100100111110000000110
010001110000000000100000011000
010000000000000000000000000100
010000000000000000000000000100
010000000000000000000111000100
001110000000000000011000110100
000001100000000001100000001000
000000011000000110000000000000
000000000111111000000000000000
000000000000000000000000000000
000000000000000000000000000000
000000000000000000000000000000