000000000000000000000000000000000000000000000000100000000000000000000000000000000000000000000000000001000000000000000000
000000000000000000000000000000000000000000000000100000000000000000000000000000000000000000000000000001000000000000000000
000000000000000000000000000000000000000000000000100000000000000000000000000000000000000000000000000001000000000000000000
000000000000000000000000000000000000000000000000100000000000000000000000000000000000000000000000000001000000000000000000
000000000000000000000000000000000000000000000000100000000000000000000000000000000000000000000000000001000000000000000000
000000000000000000000000000000000000000000000000100000000000000000000000000000000000000000000000000001000000000000000000
000000000000000000000000000000000000000000000000100000000000000000000000000000000000000000000000000001000000000000000000
000000000000000000000000000000000000000000000000100000000000000000000000000000000000000000000000000001000000000000000000
000000000000000000000000000000000000000000000000100000000000000000000000000000000000000000000000000001000000000000000000
000000000000000000000000000000000000000000000000100000000000000000000000000000000000000000000000000001000000000000000000
000000000000000000000000000000000000000000000000100000000000000000000000000000000000000000000000000001000000000000000000
000000000000000000000000000000000000000000000000100000000000000000000000000000000000000000000000000001000000000000000000
000000000000000000000000000000000000000000000000100000000000000000000000000000000000000000000000000001000000000000000000
000000000000000000000000000000000000000000000000100000000000000000000000000000000000000000000000000001000000000000000000
000000000000000000000000000000000000000000000000100000000000000000000000000000000000000000000000000001000000000000000000
000000000000000000000000000000000000000000000000100000000000000000000000000000000000000000000000000001000000000000000000
000000000000000000000000000000000000000000000000100000000000000000000000000000000000000000000000000001000000000000000000
000000000000000000000000000000000000000000000000100000000000000000000000000000000000000000000000000001000000000000000000
000000000000000000000000000000000000000000000000111111111111111111111111111111111111111000000000000001000000000000000000
000000000000000000000000000000000000000000000000000000000000000000000000000000000000001000000000000001000000000000000000
000000000000000000000000000000000000000000000000000000000000000000000000000000000000000111111000000001000000000000000000
000000000000000000000000000000000000000000000001111111111111111111111111111111111111111111111110000001000000000000000000
000000000000000000000000000000000000000000000000000000000000000000000000000000000000000000000110000001000000000000000000
000000000000000000000000000000000000000000000000000000000000000000000000000000000000000000000000000001000000000000000000
000000000000000000000000000000000000000000000000000000000000000000000000000000000000000000000000000001000000000000000000
000000000000000000000000000000000000000000000000000000000000000000000000000000000000000000000000000001000000000000000000
000000000000000000000000000000000000000000000000000000000000000000000000000000000000000000000000000001000000000000000000
000000000000000000000000000000000000000000000000000000000000000000000000000000000000000000000000000001000000000000000000
000000000000000000000000000000000000000000000000000000000000000000000011000000000000000000000000000110000000000000000000
000000000000000000000000000000000000000000000000000000000000000000000011000000000000000000000000000100000000000000000000
000000000000000000000000000000000000000000000000000000000000000000000011000000001111111111111111111000000000000000000000
000000000000000000000000000000000000000000000000000000000000000000000011000000001000000000000000000000000000000000000000
000000000000000000000000000000000000000000000000000000000000111100000011000000001000000000000000000000000000000000000000
000000000000000000000000000000000000000000000000000000000000111100000011000000001000000000000000000000000000000000000000
000000000000000000000000000000000000000000000000000000000000000000000011000000001000000000000000000000000000000000000000
000000000000000000000000000000000000000000000000000000000000000000000011222222221000000000000000000000000000000000000000
000000000000000000000000000000000000000000000000000000000000000001100010111111110000000000000000000000000000000000000000
000000000000000000000000000000000000000000000000000000000000000001100010000000000000000000000000000000000000000000000000
000000000000000000000000000000000000000000000000000000000000000000000010000000000000000000000000000000000000000000000000
000000000000000000000000000000000000000000000000000000000000000000000010000000000000000000000000000000000000000000000000
110000000000000000000000000000000000000220000000000111111111111111111100000000000000000000000000000000000000000000000000
010000000000000000000000000000000000000111111000000100000000000000000000000000000000000000000000000000000000000000000000
010000000000000000000000000000000000000100001000000100000000000000000000000000000000000000000000000000000000000000000000
010000000000000000000000000000000000000100001000000100000000000000000000000000000000000000000000000000000000000000000000
010000000000000000000000000000000000000111111000000100000000000000000000000000000000000000000000000000000000000000000000
010000000000000000000000000000000000000000000000011000000000000000000000000000000000000000000000000000000000000000000000
010000000000000000000000000000000000000000000000011000000000000000000000000000000000000000000000000000000000000000000000
010000000000000000000000000000000000000000000000000100000000000000000000000000000000000000000000000000000000000000000000
010000000000000000000000000000000000000000000000000100000000000000000000000000000000000000000000000000000000000000000000
010000000000000000000000000000000000000000000000000100000000000000000000000000000000000000000000000000000000000000000000
010000000000000000000000000000000001111111111111111010000000000000000000000000000000000000000000000000000000000000000000
010000000000000000000000000000000001000000000000000010000000000000000000000000000000000000000000000000000000000000000000
010000000000000000000000000000000001111111111111111110000000000000000000000000000000000000000000000000000000000000000000
010000000000000000000000000000000000000000000000000000000000000000000000000000000000000000000000000000000000000000000000
010000000000000000000011111111111000000000000000000000000000000000000000000000000000000000000000000000000000000000000000
010000000000000000000011111111111000000000000000000000000000000000000000000000000000000000000000000000000000000000000000
010000000000000000000000000000000000000000000000000000000000000000000000000000000000000000000000000000000000000000000000
010000000000000000000000000000000000000000000000000000000000000000000000000000000000000000000000000000000000000000000000
010000000000000000000000000000000000000000000000000000000000000000000000000000000000000000000000000000000000000000000000
010000000000000000222222222222222222222222222222222222222222222222222222200000000000000000000000000000000000000000000000
010000111111111111111111111111111111111111111111111111111111111111111111100000000000000000000000000000000000000000000000
010000111111111111111111111111111111111111111111111111111111111111111111100000000000000000000000000000000000000000000000
010000000000000000000000000000000000000000000000000000000000000000000000010000000000000000000000000000000000000000000000
010000000000000000000000000000000000000000000000000000000000000000000000010000000000000000000000000000000000000000000000
010000000000000000000000000000000000000000000000000000000000000000000000010000000000000000000000000000000000000000000000
010000000000000000000000000000000000000000000000000000000000000000000000010000000000000000000000000000000000000000000000
001111000000000000000000000000000000000000000000000000000000000000000000010000000000000000000000000000000000000000000000
000001000000000000000000000000000000000000000000000000000000000000000000010000000000000000000000000000000000000000000000
000001000000001100000000000000000000000000000000000000000000000000000000010000000000000000000000000000000000000000000000
000001000000001100000000000000000000000000000000000000000000000000000000010000000000000000000000000000000000000000000000
000001000000001100000000000000000000000000000000000000000000000000000000010000000000000000000000000000000000000000000000
000001000000001100000000000000000000000000000000000000000000000000000000010000000000000000000000000000000000000000000000
000001000000110011111100000000000000000000000000000000000000000000000000010000000000000000000000000000000000000000000000
000001222222100000000100000000000000000000000000000000000000000000000000010000000000000000000000000000000000000000000000
000000111111100000000100000000000000000000000000000000000000000000000000010000000000000000000000000000000000000000000000
000000000000000000000100000000000000000000000000000000000000000000000000010000000000000000000000000000000000000000000000
000000000000000000000011000000000000000000000000000000000000000000000000010000000000000000000000000000000000000000000000
000000000000000000000011000000000000000000000000000000000000000000000000010000000000000000000000000000000000000000000000
000000000000000000000100000000000000000000000000000000000000000000000000010000000000000000000000000000000000000000000000
000000000000000000000100000000000000000000000000000000000000000000000000010000000000000000000000000000000000000000000000
000000000000000000000100000000000000000000000000000000000000000000000000010000000000000000000000000000000000000000000000
000000000000000000000100000000000000000000000000000000000000000000000000010000000000000000000000000000000000000000000000
000000000000000000000011000000000000000000000000000000000000000000000000010000000000000000000000000000000000000000000000
000000000000000000000001000000000000000000000000000000000000000000000000010000000000000000000000000000000000000000000000
000000000000000000000000110000000000001111111111111100000000000000000000010000000000000000000000000000000000000000000000
000000000000000000000000010000000000001111111111111100000000000000000000010000000000000000000000000000000000000000000000
000000000000000000000000001100000000000000000000000000011000000000000000010000000000000000000000000000000000000000000000
000000000000000000000000000100000000000000000000000000011000000000000000010000000000000000000000000000000000000000000000
000000000000000000000000000100000000000000000000000000000000000000000000010000000000000000000000000000000000000000000000
000000000000000000000000000100000000000000000000000000000000000000000000010000000000000000000000000000000000000000000000
000000000000000000000000000100000000000000000000000000000110000000000000010000000000000000000000000000000000000000000000
000000000000000000000000000100000000000000000000000000000110000000000000010000000000000000000000000000000000000000000000
000000000000000000000000000100000000000000000000000000000000000000000000010000000000000000000000000000000000000000000000
000000000000000000000000000100000000000000000000000000000000000000000000010000000000000000000000000000000000000000000000
000000000000000000000000000100000000000000000000000000000000000000000000010000000000000000000000000000000000000000000000
000000000000000000000000000100000000000000000000000000000000000000000000010000000000000000000000000000000000000000000000
000000000000000000000000000100000000000000000000000000000110000000000000010000000000000000000000000000000000000000000000
000000000000000000000000000100000000000000000000000000000110000000000000010000000000000000000000000000000000000000000000
000000000000000000000000000100000000000000000000000000000000000000000000010000000000000000000000000000000000000000000000
000000000000000000000000000100000000000000000000000000000000000000000000010000000000000000000000000000000000000000000000
000000000000000000000000000100000000000000000000000000000000011111100000010000000000000000000000000000000000000000000000
000000000000000000000000000100000000000000000000000000000000011111100000010000000000000000000000000000000000000000000000
000000000000000000000000000100000000000000000000000000000000000000000000010000000000000000000000000000000000000000000000
000000000000000000000000000100000000000000000000000000000000000000000000010000000000000000000000000000000000000000000000
000000000000000000000000000100000000000000000000000000000000000000000000010000000000000000000000000000000000000000000000
000000000000000000000000000100000000000000000000000000000000000000000000010000000000000000000000000000000000000000000000
000000000000000000000000000100000000000000000000000000000000000000000110010000000000000000000000000000000000000000000000
000000000000000000000000000122222200000000000000000000000000000000000110010000000000000000000000000000000000000000000000
000000000000000000000000000011111111111111111100000000000000000000000000010000000000000000000000000000000000000000000000
000000000000000000000000000000000000000000000100000000000000000000000000010000000000000000000000000000000000000000000000
000000000000000000000000000000000000000000000100000000000000000000000000010000000000000000000000000000000000000000000000
000000000000000000000000000000000000000001111100000000000000000000000000010000000000000000000000000000000000000000000000
000000000000000000000000000000000000000010000000000000000000000000000001100000000000000000000000000000000000000000000000
000000000000000000000000000000000001111110000000000000000000000000000001100000000000000000000000000000000000000000000000
000000000000000000000000000000000010000000000000111111111111111100000000010000000000000000000000000000000000000000000000
000000000000000000000000000000000010000000000000111111111111111100000000010000000000000000000000000000000000000000000000
000000000000000000000000000000000010000000000000000000000000000000000000010000000000000000000000000000000000000000000000
000000000000000000000000000000000010000000000000000000000000000000000000010000000000000000000000000000000000000000000000
000000000000000000000000000000000010011111111100000000000000000000000000010000000000000000000000000000000000000000000000
000000000000000000000000000000000010011111111100000000000000000000000000010000000000000000000000000000000000000000000000
000000000000000000000000000000000010000000000011000000000000000000000111100000000000000000000000000000000000000000000000
000000000000000000000000000000000010000000000011000000000000000000000111100000000000000000000000000000000000000000000000
000000000000000000000000000000000010000000000000111111000000000000000000010000000000000000000000000000000000000000000000
000000000000000000000000000000000010000000000000111111000000000000000000010000000000000000000000000000000000000000000000
000000000000000000000000000000000010000000000000000000000000000000000001100000000000000000000000000000000000000000000000
000000000000000000000000000000000010000000000000000000000000000000000001100000000000000000000000000000000000000000000000
000000000000000000000000000000000010000000000000000000000000000000000000010000000000000000000000000000000000000000000000
000000000000000000000000000000000010000000000000000000000000000000000000010000000000000000000000000000000000000000000000
000000000000000000000000000000000010000000000000000000000000000000000000010000000000000000000000000000000000000000000000
000000000000000000000000000000000010000000000000000000000000011111111111100000000000000000000000000000000000000000000000
000000000000000000000000000000000010000000000000000000000000011111111111100000000000000000000000000000000000000000000000
000000000000000000000000000000000001111111110000000000000000000000000000010000000000000000000000000000000000000000000000
000000000000000000000000000000000000000111110000001111100000000000000000010000000000000000000000000000000000000000000000
000000000000000000000000000000000000001000000000001111100000000000000000010000000000000000000000000000000000000000000000
000000000000000000000000000000000000001000000000000000000000000000000000010000000000000000000000000000000000000000000000
000000000000000000000000000000000000001000000000000000000000000000000000010000000000000000000000000000000000000000000000
000000000000000000000000000000000000001000000000000000000000000000000000010000000000000000000000000000000000000000000000
000000000000000000000000000000000000000111100000000000000000000000000000010000000000000000000000000000000000000000000000
000000000000000000000000000000000000000000100000000000000000000000000000010000000000000000000000000000000000000000000000
000000000000000000000000000000000000000000100000000000000000000000000000010000000000000000000000000000000000000000000000
000000000000000000000000000000000000000000100000000000000000000000002222210000000000000000000000000000000000000000000000
000000000000000000000000000000000000000000011111111111100001111111111111100000000000000000000000000000000000000000000000
000000000000000000000000000000000000000000000000000000100001000000000000000000000000000000000000000000000000000000000000
000000000000000000000000000000000000000000000000000000100001000000000000000000000000000000000000000000000000000000000000
000000000000000000000000000000000000000000000000000000100000000000000000000000000000000000000000000000000000000000000000
000000000000000000000000000000000000000000000000000000000000000000000000000000000000000000000000000000000000000000000000
000000000000000000000000000000000000000000000000000000000000000000000000000000000000000000000000000000000000000000000000
000000000000000000000000000000000000000000000000000000000000000000000000000000000000000000000000000000000000000000000000
000000000000000000000000000000000000000000000000000000000000000000000000000000000000000000000000000000000000000000000000
000000000000000000000000000000000000000000000000000000000000000000000000000000000000000000000000000000000000000000000000