000000000000000000000000000000010000000000000000001000000000
000000000000000000000000000001110000000000000000001110000000
001111100000000000000000000010000000000000000000000001000000
010000010000110111110000000100000000000000000000000001000000
010000011111001000001111111100000000000000000000000001000000
010000110000001000000000000000000000000000011100000001000000
010000000000001000000000000000001111110001110100000001110000
001100000000001000000000000000001000010000011100000000001000
010000000000001000000000000000001000010000000000000000001000
010000011111000000000000000000110001110000000000110000001000
010000000000000000011111111111000010000000000000110000001000
001100000000000001100000000000000010000000000000000000001000
000100000000000000010000000000000010000000000000000011110000
000100000000000000010000000000000010011111000100000000001100
000011111100011111100000000000111100000000000100000000000010
000000000100010000000000000001000000000000000100000000000010
000000000100010000000000000001000000000000000100011100000010
000000000100010000000000000010000000000000000000010100000010
000000000100001000000000000010000000000000000000100100000100
000000111000000100000010000010000000000000000000100011000100
000001000000000111111101111100000000000000000011100011000100
000001000000000000000000000000000000000000000000010100000100
000111000000000000000000000000000000000000000000010100001000
001000000000000000000000000000000000000000000000010100000100
001000000000000000000000000001111111000000000001100011001000
001000000011100000000000000001000000111000011110000000110000
001000000010011000000000000010000000000111100000000000000000
001000000010100000000000000001000000000000000000000000000000
010000000001000000111000000000100000000000000000000000000000
010001111110110000000000000000100000000000000000000000000000
010000000001000000000000001111000000000000000000000000000000
010000000000000000000000000000100000000000000000000000000000
010000000000000000000000000000100000000000000000000000000000
010000000000000000000000100001000000000000000000000000000000
001000000000000000000011011001000000000000000000000000000000
000110000001111110001100000110000000000000000000000000000000
000001111110000001110000000000000000000000000000000000000000
000000000000000000000000000000000000000000000000000000000000
000000000000000000000000000000000000000000000000000000000000
000000000000000000000000000000000000000000000000000000000000